40 40 25
wwwwwwwwwwwwwwwwwwwwwwwwwwwwwwwwwwwwwwww
w00000000000000000000000000000000000000w
w00000000000000000000000000000000000000w
w00000000000000000000000000000000000000w
w0000000000w000000000000000000000000000w
w0000000000w000000000000000000000000000w
w0000000000w000000000000000000000000000w
w00000000000000000000000000000000000000w
w00000000000000000000000000000000000000w
w00000000000000000000www000000000000000w
w00000000000000000000000000000000000000w
w00000000000000000000000000000000000000w
w00000000000000000000000000000000000000w
w00000000000000000000000000000000000000w
w0000000000www0000000000000000000000000w
w00000000000000000000000000000000000000w
w000000000000000000000w0000000000000000w
w00000000000000000000000000000000000000w
w00000000000000000000000000000000000000w
w00000000000000000000000000000000000000w
w0000wwwwww00000000000000ww000000000000w
w00000000ww00000000000000ww000000000000w
w00000000ww00000000000000wwwwww00000000w
w0000wwwwww0000000000000000000000000000w
w00000000000000000000000000000000000000w
w00000000000000000000000000000000000000w
w00000000000000000000000000000000000000w
w00000000000000000000000000000000000000w
w00000000000000000000000000000000000000w
w00000000000000000000000000000000000000w
w00000000000000000000000000000000000000w
w00000000000000000000000000000000000000w
w00000000000000000000000000000000000000w
w00000000000000000000000000000000000000w
w00000000000000000000000000000000000000w
w00000000000000000000000000000000000000w
w00000000000000000000000000000000000000w
w00000000000000000000000000000000000000w
w00000000000000000000000000000000000000w
wwwwwwwwwwwwwwwwwwwwwwwwwwwwwwwwwwwwwwww